iron=Iron
gold=Gold
copper=Copper
tin=Tin
bronze=Bronze
electrum=Electrum
invar=Invar
nickel=Nickel
zinc=Zinc
brass=Brass
silver=Silver
steel=Steel
lead=Lead
platinum=Platinum
cupronickel=Cupronickel
signalum=Signalum
lumium=Lumium
enderium=Enderium
alumina=Alumina
aluminium=Aluminium
chrome=Chromium
redstone=Redstone
glowstone=Glowstone
enderpearl=Ender Pearl
obsidian=Obsidian
coal=Coal
charcoal=Charcoal
black=Black
red=Red
green=Green
brown=Brown
blue=Blue
purple=Purple
cyan=Cyan
light_gray=Light Gray
gray=Gray
pink=Pink
lime=Lime
yellow=Yellow
light_blue=Light Blue
magenta=Magenta
orange=Orange
white=White

